EA path/east.xpm
SO path/south.xpm
WE path/west.xpm
NO path/north.xpm

C 88,5,54
F 255,23,0

        1111111111111111111111111
    1   1111111111110000000000001111
1         11011000001110000000000001
        1110010000000000000S00000011
11111111101100000111000000000000111
100000000011000001110100000011111
11110111111111011100000010001
11110111111111011101010010001
11000000110101011100000010001
10000000000000001100000010001
10000000000000001101010010001
1100000111010101111101111000111
11110111 1110101 101111010001
11111111 1111111 111111111111