NO path/north.xpm
EA path/east.xpm
SO path/south.xpm
WE path/west.xpm

C 225,30,0
F 0,0,255

111111111
1N0000001
100000001
100010001
100000001
101100001
100000001
111111111