 11111111111111111111111
1000000000110000000000001
1011000001110000000000001
10010000000000000000000011111111
111111111011000001110000000000001
10000000001100000111011111111111
11110111111111011100000010001
11110111111111011101010010001
11000000110101011100000010001
100000S0000000001100000010001
10000000000000001101010010001
1100000111010101111101111000111
1 110111  110101 101111010001 
    1       1 1   1    1 111 
